1 16 4750 4507 4522 2816 1395 4528 4519 4645 4488 1277 1713 2692 4441 2144 4447 2895 
1 8 4522 2043 4564 932 5909 4667 1793 1866 
1 5 4661 4629 1922 3004 4528 
2 10 1619 5084 2794 1377 4911 4856 4807 1658 4725 1866 
1 9 4655 4623 579 838 4527 4512 4534 4506 4750 
1 3 5108 977 1619 
2 7 4661 4668 4749 2139 2750 4790 2015 
1 5 5140 2140 5091 3283 1377 
2 4 3607 2650 223 3589 
1 6 3459 3495 3496 116 2229 3589 
1 8 4297 4350 2866 4385 426 6357 4773 4507 
1 11 6002 5996 2415 2564 5868 151 2565 3101 1066 970 5934 
1 7 5219 5727 5673 5636 333 2455 5449 
1 9 3084 5247 2622 3070 5449 5505 5499 5559 5596 
1 7 5571 1306 5714 5767 5820 5839 5868 
1 10 5933 5850 2090 985 617 5750 1586 5735 848 5219 
1 16 2376 6934 5168 1345 6892 201 6865 1590 1804 6977 5042 6806 1158 6815 5088 2073 
1 5 1590 6877 6901 5519 950 
1 4 6862 835 479 6806 
